FE8 - Fields - 01000203
22 23
953 954 955 163 815 785 596 598 98 98 599 823 767 605 98 132 944 818 849 845 846 847 137
985 986 987 98 131 98 2 98 631 630 98 599 823 534 98 98 782 849 163 877 878 879 46
723 163 131 131 67 631 605 98 599 605 98 98 2 2 98 684 162 162 163 909 910 911 98
721 98 631 531 563 821 605 98 98 600 98 98 659 598 98 98 685 684 782 759 726 760 817
817 99 636 796 796 796 534 98 98 628 34 570 627 130 130 782 98 685 130 758 763 792 198
98 98 532 824 796 796 534 720 782 98 98 98 782 720 164 720 98 98 720 789 98 198 435
77 631 895 830 795 796 534 98 631 691 34 597 98 720 783 98 685 163 782 270 273 433 305
98 636 830 822 634 823 605 98 636 598 98 599 630 98 815 163 782 208 273 231 230 231 783
98 532 822 598 932 636 605 99 2 98 98 720 599 597 98 98 782 162 238 67 720 899 67
98 659 598 98 98 659 598 498 628 597 98 99 98 2 98 98 164 162 162 684 162 67 684
34 627 98 596 570 627 782 782 596 629 98 782 131 628 570 630 162 720 721 783 784 785 685
98 98 98 2 98 98 596 571 598 98 98 782 67 684 98 628 630 130 782 66 720 67 720
631 630 98 600 98 98 600 98 720 70 77 98 98 720 720 35 632 99 66 743 774 67 848
636 605 98 532 34 570 629 98 782 46 98 98 130 782 99 99 600 98 384 544 718 721 130
659 598 98 600 98 98 98 44 71 98 198 199 163 130 99 98 632 98 594 456 496 721 721
627 98 44 2 782 98 98 98 102 131 293 131 131 131 163 631 598 721 684 594 780 720 782
70 77 631 598 14 98 98 100 100 784 785 99 131 596 570 598 720 720 817 836 652 848 804
169 98 600 70 167 782 720 67 100 815 67 100 631 598 66 99 162 782 900 130 99 99 131
774 98 628 539 570 539 539 539 630 631 597 631 598 817 66 70 79 45 98 782 720 98 132
690 777 99 98 35 100 100 35 599 598 599 598 100 98 78 46 46 98 198 199 98 782 98
747 593 815 163 100 100 100 100 164 131 100 782 720 932 6 137 98 208 401 231 132 98 132
98 163 816 817 98 98 14 130 782 332 337 337 261 99 142 143 99 99 238 784 723 720 98
