FE8 - Fields - 01000203
30 27
491 429 718 815 720 98 600 98 106 782 495 587 545 614 423 583 424 592 44 103 165 44 82 6 71 720 70
587 545 528 849 98 131 628 570 630 98 559 524 549 419 618 779 589 684 98 720 782 70 6 6 6 79 6
524 424 560 163 782 67 684 98 600 98 899 559 524 456 429 649 721 804 98 44 43 111 103 166 38 38 38
418 618 529 99 130 98 98 98 600 98 361 98 689 587 513 496 783 783 783 130 817 720 98 134 6 6 38
522 429 429 497 720 98 98 631 605 98 98 782 684 495 587 579 580 544 497 782 849 848 70 6 38 38 114
581 545 429 560 848 720 99 636 598 98 98 98 98 559 524 456 550 424 560 782 67 130 102 111 114 167 782
586 456 429 529 98 98 98 600 98 98 782 782 130 786 559 587 562 618 529 782 98 836 782 782 99 900 98
615 619 545 496 720 653 98 600 35 198 273 199 720 65 782 495 424 429 429 529 98 98 720 66 782 162 98
555 416 618 560 98 98 596 629 98 178 433 271 720 817 782 594 424 429 492 496 783 208 199 782 66 782 98
556 521 528 849 131 98 600 816 130 98 230 231 782 98 98 626 456 492 551 545 497 782 144 205 720 198 199
619 425 560 818 98 631 605 848 98 98 782 67 99 98 98 679 689 780 687 559 780 208 433 265 782 144 271
587 454 529 817 98 599 605 98 685 162 783 782 131 720 782 98 98 98 720 685 804 782 230 401 273 435 176
495 587 545 593 98 98 600 782 98 198 273 209 720 198 199 99 98 932 71 98 99 98 782 144 433 401 177
495 523 458 718 720 208 2 45 782 230 231 98 652 230 231 162 98 932 46 98 98 99 130 306 403 231 783
495 555 458 560 66 98 628 570 630 98 98 98 98 782 162 162 98 720 817 208 337 261 98 98 178 209 67
524 451 424 649 745 98 684 98 600 98 208 273 263 203 782 684 679 721 849 162 198 433 199 98 98 99 99
525 485 424 496 66 44 71 98 600 98 98 178 433 265 99 720 783 721 711 721 230 305 403 199 685 162 162
721 689 747 592 66 70 167 99 628 630 98 98 178 295 98 720 67 684 684 946 98 782 230 231 99 130 163
712 721 783 720 44 167 107 98 99 600 98 98 98 782 162 163 782 98 98 782 98 395 98 720 162 782 162
496 783 130 98 98 98 782 98 99 628 570 570 571 570 630 98 782 596 570 538 630 368 273 209 162 70 79
545 497 99 202 203 98 784 162 782 98 98 98 98 98 628 630 631 605 720 67 2 435 231 162 70 167 102
618 560 720 234 235 163 720 164 99 720 162 782 98 98 98 599 634 598 130 782 2 307 98 70 169 98 742
780 720 782 99 208 337 209 99 99 66 720 817 98 782 720 98 98 98 720 98 600 782 44 167 743 749 581
98 652 684 685 98 99 99 99 98 782 130 130 130 130 848 720 783 98 98 98 600 98 782 384 517 454 585
782 783 941 942 943 782 74 75 98 98 130 743 99 99 99 782 99 98 631 570 629 98 684 495 555 556 580
782 815 973 974 975 98 142 137 98 98 752 457 497 720 99 720 98 631 598 98 98 98 98 430 451 417 550
75 98 1005 1006 1007 98 102 103 98 98 594 587 657 782 98 98 596 598 98 98 816 817 98 559 485 424 551
109 98 817 230 273 199 782 162 720 132 782 495 513 529 782 98 600 70 79 135 848 849 782 98 495 456 614
162 685 163 817 230 231 384 750 130 99 99 495 587 544 497 684 600 102 6 6 45 162 652 679 689 587 545
721 816 817 130 98 778 746 560 817 679 493 524 555 458 560 98 600 70 6 169 782 98 685 778 750 594 424
